##########################################################################################
#P.......................................................................................#
#........................................................................................#
#........................................................................................#
#........................................................................................#
#........................................................................................#
#........................................................................................#
#........................................................................................#
#........................................................................................#
#...........................................................E............................#
#........................................................................................#
#........................................................................................#
#........................................................................................#
#........................................................................................#
#........................................................................................#
#........................................................................................#
#........................................................................................#
#........................................................................................#
#.............................................................................E..........#
#........................................................................................#
#........................................................................................#
#........................................................................................#
#........................................................................................#
#..........................................E.............................................#
#........................................................................................#
#........................................................................................#																				  #
#........................................................................................#																				  #
#........................................................................................#
#........................................................................................#
##########################################################################################