###########################
#.........................#
#............P............#
#.........................#
#.........................#
#.........................#
#.........................#
#.........................#
#.........................#
###########################